 ########
##      #
#   .   #
#   $   #
# .$@$. #
####$   #
   #.   #
   #   ##
   #####
;
################
##@         .###
##           ###
#.  #######    #
#   #######    #
#       ###    #
#        ##    #
#         $    #
#    $       $ #
#   ##     $  ##
#   ##        ##
#   ##        ##
##. ##       .##
################
;