 ########
##      #
#   .   #
#   $   #
# .$@$. #
####$   #
   #.   #
   #   ##
   #####
;
 #######
 #.... #
###...$###
#  $#$ $ #
# $$  #$ #
#    #   #
####@  ###
   #####
;