 ########
##      #
#   .   #
#   $   #
# .$@$. #
####$   #
   #.   #
   #   ##
   #####
;
 ##############
 ##@       .###
 ##      $   ##
 #.  #####    #
 #     ###    #
 #      ##    #
 #       $    #
 #   #      $ #
 #   #    $  ##
 ##. ###   .###
 ##############
;